I am very tired | I'm spent. / I'm wiped.
It is expensive | It's a bit pricey.
How are you? | How's it going? / What's up?
I understand | Got it. / Makes sense.
I will think about it | I'll sleep on it.
I like that | I’m a fan of that. / I'm into it.
Wait a moment | Hang on a sec.
I do not know | I'm not (entirely) sure.
You are welcome | Anytime. / No worries.
I am going to leave | I'm gonna head out.
You are welcome | No problem / Don't mention it.
I am very excited | I can't wait!
I am sorry | My bad. / Whoops.
I do not like it | It’s not really my thing.
I am very busy | I'm swamped. / My hands are tied.
Tell me more | I'm all ears.
I agree with you | I’m on board. / I’m with you.
It is easy | It's a breeze. / No biggie.
I will call you later | I'll give you a shout.
Goodbye | Catch you later! / Take care!
I am going to... | I'm about to...
It is very cold | It's freezing!
I am listening to you | Go ahead.
I will help you | Let me give you a hand.
That is a good idea | That works!
Do you want to...? | Wanna...?
I think that... | I feel like... / I reckon...
It is your turn | You're up!
I do not believe it | No way!
I forgot | It slipped my mind.
That is a very good idea| That’s solid idea.
You should do that | Go for it.
Can you repeat that? | Come again? / Sorry, missed that.
I will think about it | I’ll give it some thought. / Let me chew on that.
It is my mistake | That's on me. / My fault.
I am very happy for you | Good for you! / That's great to hear!
It is not important | It’s no big deal. / No biggie.
I have to go now | I’ve gotta bolt. / I’m off.
That is very funny | That’s hilarious! / (It) cracked me up.
I am very hungry | I'm starving. / I'm famished.
I do not care | It doesn't matter to me. / I'm easy (to please).
I will do it later | I'll get around to it.
Can I help you? | Need a hand?
I am going to bed | I’m gonna hit the sack. / I'm crashing.
That is very strange | That’s a bit odd. / That's sketchy.
I am very surprised | I’m blown away. / No way!
It is very easy | It’s a piece of cake. / It's a walk in the park.
Please be quiet | Keep it down.
I do not understand | I don’t get it. / I’m lost.
I am very angry | I’m fuming. / I’m ticked off.
I want to buy this | I’ll take it. 
Are you busy? | Got a sec?
I am very nervous | I’ve got butterflies (in my stomach). 
That is very boring | It’s like watching paint dry.
I will pay the bill | It’s on me. / My treat.
I am joking | I’m just kidding. / I'm just pulling your leg.
It is time to start | Let’s get the ball rolling.
I can't think of her name | Her name escapes me.
I am very busy | My schedule is packed. / I'm tied up.
You are right/I agree | You hit the nail on the head. / Tell me about it!


